1111111111
1001110001
1000000101
1000000101
1000000101
1010000001
1111010101
1000000001
1010101001
1111111111
