1111111111
1001110001
1000000001
1000010011
1000010001
1000010001
1010011111
1000000001
1010101001
1111111111
